{
  "1": "2",
  "3": "6",
  "4": "8",
  "5": "4",
  "6": "9",
  "7": "3",
  "8": "10",
  "9": "5",
  "10": "7",
  "11": "11"
}